,Player,Pos,Team,FGM,FGA,FTM,FTA,_3PM,REB,AST,STL,BLK,TO,PTS,FGM_pm,FT_pm,NEGPTS,POSPTS,TOTPTS,Rk
0,Precious Achiuwa,C,TOR,530,-603,78,-131,56,473,164,148,164,-168,664,-73,-53,-902,2277,1375,1
1,Steven Adams,C,MEM,420,-384,108,-199,0,760,512,260,240,-230,528,36,-91,-813,2828,2015,2
2,Bam Adebayo,C,MIA,812,-729,256,-340,0,564,380,320,176,-296,1068,83,-84,-1365,3576,2211,3
3,Santi Aldama,PF,MEM,106,-132,20,-32,6,87,42,24,40,-32,132,-26,-12,-196,457,261,4
4,LaMarcus Aldridge,C,BRK,504,-458,89,-102,14,258,84,56,188,-88,607,46,-13,-648,1800,1152,5
5,Nickeil Alexander-Walker,SG,TOT,506,-680,81,-109,105,187,312,184,92,-186,692,-174,-28,-975,2159,1184,6
6,Grayson Allen,SG,MIL,510,-569,64,-74,159,222,200,184,72,-86,733,-59,-10,-729,2144,1415,7
7,Jarrett Allen,C,CLE,738,-545,165,-233,1,602,184,176,300,-188,904,193,-68,-966,3070,2104,8
8,Jose Alvarado,PG,NOP,262,-294,36,-53,32,100,304,284,28,-80,330,-32,-17,-427,1376,949,9
9,Justin Anderson,SF,TOT,72,-95,15,-19,15,46,66,32,24,-16,102,-23,-4,-130,372,242,10
10,Kyle Anderson,PF,MEM,418,-469,67,-105,36,368,366,308,180,-142,521,-51,-38,-716,2264,1548,11
11,Giannis Antetokounmpo,PF,MIL,1378,-1245,553,-766,71,778,776,288,364,-438,2002,133,-213,-2449,6210,3761,12
12,Thanasis Antetokounmpo,SF,MIL,140,-128,29,-46,2,101,44,64,48,-52,171,12,-17,-226,599,373,13
13,Carmelo Anthony,PF,LAL,638,-723,132,-159,149,288,136,188,208,-118,919,-85,-27,-1000,2658,1658,14
14,Cole Anthony,PG,ORL,714,-912,216,-253,132,348,738,184,68,-340,1062,-198,-37,-1505,3462,1957,15
15,OG Anunoby,SF,TOR,618,-697,89,-118,115,264,250,284,100,-160,822,-79,-29,-975,2542,1567,16
16,Ryan Arcidiacono,PG,NYK,12,-12,0,0,4,8,8,4,0,-6,16,0,0,-18,52,34,17
17,Trevor Ariza,SF,LAL,66,-99,10,-18,20,82,54,52,24,-22,96,-33,-8,-139,404,265,18
18,D.J. Augustin,PG,TOT,188,-222,38,-43,68,68,214,68,4,-112,294,-34,-5,-377,942,565,19
19,Deni Avdija,SF,WAS,500,-579,103,-136,82,425,334,236,176,-174,685,-79,-33,-889,2541,1652,20
20,Joel Ayayi,SG,WAS,2,-6,0,0,0,3,8,0,0,0,2,-4,0,-6,15,9,21
21,Deandre Ayton,C,PHO,884,-697,106,-142,7,593,168,160,160,-182,997,187,-36,-1021,3075,2054,22
22,Udoka Azubuike,C,UTA,74,-49,6,-11,0,71,0,4,44,-24,80,25,-5,-84,279,195,23
23,Marvin Bagley III,PF,TOT,450,-446,67,-101,23,338,72,88,72,-78,540,4,-34,-625,1650,1025,24
24,LaMelo Ball,PG,CHO,1076,-1254,212,-243,220,501,1142,476,120,-490,1508,-178,-31,-1987,5255,3268,25
25,Lonzo Ball,PG,CHI,324,-383,21,-28,110,190,356,256,124,-164,455,-59,-7,-575,1836,1261,26
26,Mo Bamba,C,ORL,592,-617,57,-73,107,572,170,152,472,-154,756,-25,-16,-844,2878,2034,27
27,Desmond Bane,SG,MEM,1016,-1101,140,-155,228,334,416,368,116,-222,1384,-85,-15,-1478,4002,2524,28
28,Dalano Banton,PG,TOR,166,-202,26,-44,13,124,198,112,40,-106,205,-36,-18,-352,884,532,29
29,Cat Barber,PG,ATL,0,-4,0,-4,0,3,6,0,0,-2,0,-4,-4,-10,9,-1,30
30,Harrison Barnes,PF,SAC,782,-834,341,-413,142,432,372,212,56,-236,1265,-52,-72,-1483,3602,2119,31
31,Scottie Barnes,PF,TOR,918,-932,158,-215,58,557,512,320,220,-272,1134,-14,-57,-1419,3877,2458,32
32,RJ Barrett,SF,NYK,974,-1194,290,-406,138,408,416,172,64,-302,1402,-220,-116,-1902,3864,1962,33
33,Will Barton,SG,DEN,784,-896,102,-127,157,340,552,220,124,-254,1043,-112,-25,-1277,3322,2045,34
34,Paris Bass,SF,PHO,4,-6,2,-2,0,4,0,4,0,-4,6,-2,0,-12,20,8,35
35,Charles Bassey,C,PHI,60,-47,9,-12,0,62,14,20,68,-16,69,13,-3,-75,302,227,36
36,Keita Bates-Diop,SF,SAS,272,-263,46,-61,17,231,82,108,56,-90,335,9,-15,-414,1147,733,37
37,Nicolas Batum,PF,LAC,358,-387,25,-38,108,254,200,232,168,-80,491,-29,-13,-505,1836,1331,38
38,Kent Bazemore,SF,LAL,90,-139,13,-17,29,69,68,100,36,-42,132,-49,-4,-198,537,339,39
39,Darius Bazley,PF,OKC,548,-649,117,-170,80,436,194,232,280,-180,745,-101,-53,-999,2632,1633,40
40,Bradley Beal,SG,WAS,696,-771,169,-203,63,189,530,144,60,-270,928,-75,-34,-1244,2779,1535,41
41,Malik Beasley,SG,MIN,664,-850,49,-60,240,227,232,172,48,-86,953,-186,-11,-996,2585,1589,42
42,Jordan Bell,C,CHI,0,0,0,0,0,1,0,4,0,0,0,0,0,0,5,5,43
43,DeAndre' Bembry,SF,TOT,248,-221,21,-35,15,163,132,196,100,-62,284,27,-14,-318,1159,841,44
44,Dāvis Bertāns,PF,TOT,198,-275,36,-40,77,117,62,68,48,-38,311,-77,-4,-353,917,564,45
45,Patrick Beverley,PG,MIN,354,-436,96,-133,83,240,536,268,208,-146,533,-82,-37,-715,2318,1603,46
46,Saddiq Bey,SF,DET,900,-1136,210,-254,211,441,466,292,64,-192,1321,-236,-44,-1582,3905,2323,47
47,Khem Birch,C,TOR,194,-200,53,-71,0,239,112,120,104,-58,247,-6,-18,-329,1069,740,48
48,Goga Bitadze,C,IND,262,-252,64,-94,23,177,110,84,168,-92,349,10,-30,-438,1237,799,49
49,Bismack Biyombo,C,PHO,172,-145,38,-71,0,167,46,48,104,-50,210,27,-33,-266,785,519,50
50,Nemanja Bjelica,C,GSW,320,-342,59,-81,54,294,318,164,104,-174,433,-22,-22,-597,1746,1149,51
51,Eric Bledsoe,PG,LAC,394,-468,89,-117,51,182,450,276,76,-232,534,-74,-28,-817,2052,1235,52
52,Keljin Blevins,SF,POR,68,-111,6,-11,21,45,38,52,4,-34,95,-43,-5,-156,329,173,53
53,Bogdan Bogdanović,SG,ATL,684,-794,97,-115,169,250,388,272,56,-140,950,-110,-18,-1049,2866,1817,54
54,Bojan Bogdanović,PF,UTA,844,-928,223,-260,181,296,240,136,4,-236,1248,-84,-37,-1424,3172,1748,55
55,Bol Bol,PF,DEN,30,-27,2,-5,1,20,10,4,8,-8,33,3,-3,-40,108,68,56
56,Leandro Bolmaro,SF,MIN,34,-54,11,-13,5,43,42,24,0,-26,50,-20,-2,-93,209,116,57
57,Isaac Bonga,SF,TOR,6,-13,5,-8,1,7,8,32,8,-4,12,-7,-3,-25,79,54,58
58,Devin Booker,SG,PHO,1324,-1421,315,-363,183,342,658,308,104,-324,1822,-97,-48,-2108,5056,2948,59
59,Brandon Boston Jr.,SG,LAC,250,-325,59,-72,34,111,102,104,52,-62,343,-75,-13,-459,1055,596,60
60,Chris Boucher,SF,TOR,536,-577,150,-193,68,494,50,196,300,-84,754,-41,-43,-854,2548,1694,61
61,James Bouknight,SG,CHO,98,-141,27,-31,17,52,52,28,4,-30,142,-43,-4,-202,420,218,62
62,Avery Bradley,SG,LAL,296,-350,16,-18,82,136,94,212,36,-76,394,-54,-2,-444,1266,822,63
63,Tony Bradley,C,CHI,144,-123,19,-29,0,186,54,40,132,-68,163,21,-10,-220,738,518,64
64,Ignas Brazdeikis,SF,ORL,162,-188,21,-32,27,72,74,40,12,-34,210,-26,-11,-254,618,364,65
65,Mikal Bridges,SF,PHO,916,-858,131,-157,115,347,370,384,144,-136,1162,58,-26,-1151,3569,2418,66
66,Miles Bridges,PF,CHO,1192,-1214,267,-333,154,559,600,296,268,-300,1613,-22,-66,-1847,4949,3102,67
67,Oshae Brissett,SF,IND,416,-506,114,-164,83,358,144,176,116,-108,613,-90,-50,-778,2020,1242,68
68,Malcolm Brogdon,PG,IND,486,-543,143,-167,58,185,424,120,56,-154,687,-57,-24,-864,2159,1295,69
69,Armoni Brooks,SG-PG,TOT,196,-289,18,-21,74,103,124,112,44,-54,288,-93,-3,-364,959,595,70
70,Dillon Brooks,SF,MEM,454,-526,90,-106,46,102,176,144,32,-100,590,-72,-16,-732,1634,902,71
71,Bruce Brown,SF,BRK,512,-506,97,-128,38,345,296,308,208,-112,647,6,-31,-746,2451,1705,72
72,Charlie Brown Jr.,SG,TOT,20,-39,9,-10,1,32,12,40,16,-10,30,-19,-1,-59,160,101,73
73,Chaundee Brown Jr.,SG-SF,TOT,20,-32,5,-6,6,16,8,8,0,-2,31,-12,-1,-40,94,54,74
74,Greg Brown III,SF,POR,162,-190,44,-65,19,135,70,104,96,-72,225,-28,-21,-327,855,528,75
75,Jaylen Brown,SF,BOS,1152,-1217,241,-318,166,404,462,280,72,-356,1559,-65,-77,-1891,4336,2445,76
76,Moses Brown,C,TOT,128,-108,43,-72,0,135,2,28,64,-40,171,20,-29,-220,571,351,77
77,Sterling Brown,SG,DAL,118,-155,14,-15,28,149,68,56,28,-46,160,-37,-1,-216,621,405,78
78,Troy Brown Jr.,SF,CHI,216,-258,20,-26,47,203,132,144,20,-52,283,-42,-6,-336,1065,729,79
79,Jalen Brunson,SG,DAL,1012,-1008,179,-213,94,309,754,264,12,-248,1285,4,-34,-1469,3909,2440,80
80,Thomas Bryant,C,WAS,154,-148,35,-40,12,108,46,24,84,-38,201,6,-5,-226,664,438,81
81,Shaq Buchanan,SG,MEM,2,-4,0,0,0,2,4,4,0,-4,2,-2,0,-8,14,6,82
82,Reggie Bullock,SF,DAL,402,-501,40,-48,141,241,166,164,56,-80,583,-99,-8,-629,1793,1164,83
83,Trey Burke,PG,DAL,168,-215,20,-23,26,33,114,48,0,-52,214,-47,-3,-290,623,333,84
84,Alec Burks,SG,NYK,570,-728,217,-264,157,397,478,340,104,-182,944,-158,-47,-1174,3207,2033,85
85,Jared Butler,SG,UTA,122,-151,11,-16,28,45,126,68,32,-66,161,-29,-5,-233,593,360,86
86,Jimmy Butler,SF,MIA,796,-829,396,-455,27,336,624,376,108,-242,1219,-33,-59,-1526,3882,2356,87
87,Devontae Cacok,PF,SAS,42,-31,4,-7,0,42,12,32,28,-6,46,11,-3,-44,206,162,88
88,Kentavious Caldwell-Pope,SG,WAS,722,-829,137,-154,159,261,290,332,104,-194,1018,-107,-17,-1177,3023,1846,89
89,Facundo Campazzo,PG,DEN,214,-296,60,-78,58,117,440,252,92,-134,332,-82,-18,-508,1565,1057,90
90,Vlatko Čančar,PF,DEN,46,-41,9,-14,7,31,34,8,12,-18,62,5,-5,-73,209,136,91
91,Devin Cannady,PG,ORL,30,-44,5,-7,15,6,20,20,12,-10,50,-14,-2,-61,158,97,92
92,Clint Capela,C,ATL,740,-604,80,-169,0,877,184,220,372,-88,820,136,-89,-861,3293,2432,93
93,Vernon Carey Jr.,C,TOT,14,-13,6,-13,0,12,0,8,4,-6,20,1,-7,-32,64,32,94
94,Jevon Carter,PG,TOT,196,-253,15,-18,66,110,192,96,56,-68,277,-57,-3,-339,1008,669,95
95,Wendell Carter Jr.,PF,ORL,718,-684,143,-207,70,648,342,144,172,-234,931,34,-64,-1125,3168,2043,96
96,Alex Caruso,SG,CHI,204,-256,58,-73,42,148,330,284,60,-114,304,-52,-15,-443,1430,987,97
97,Willie Cauley-Stein,C,TOT,32,-35,1,-2,1,40,20,24,12,-14,34,-3,-1,-51,164,113,98
98,Ahmad Caver,SG,IND,2,-1,0,0,0,0,0,0,0,0,2,1,0,-1,4,3,99
99,Justin Champagnie,SF,TOR,62,-67,9,-9,10,72,22,32,16,-16,81,-5,0,-92,304,212,100
100,Zylan Cheatham,SF,UTA,0,-3,0,0,0,0,0,0,0,0,0,-3,0,-3,0,-3,101
101,Chris Chiozza,PG,GSW,48,-81,2,-3,17,36,130,52,0,-64,67,-33,-1,-148,352,204,102
102,Marquese Chriss,PF,DAL,124,-134,22,-33,8,103,34,52,48,-34,154,-10,-11,-201,545,344,103
103,Josh Christopher,SG,HOU,448,-500,83,-113,56,186,300,260,52,-228,587,-52,-30,-841,1972,1131,104
104,Gary Clark,PF,NOP,66,-88,7,-10,28,90,36,52,28,-20,101,-22,-3,-118,408,290,105
105,Brandon Clarke,PF,MEM,576,-447,85,-130,5,342,172,156,272,-68,666,129,-45,-645,2274,1629,106
106,Jordan Clarkson,SG,UTA,932,-1113,144,-174,190,273,388,264,64,-258,1266,-181,-30,-1545,3521,1976,107
107,Nic Claxton,C,BRK,356,-264,54,-93,0,264,86,96,204,-76,410,92,-39,-433,1470,1037,108
108,Amir Coffey,SG,LAC,422,-466,101,-117,96,197,248,152,60,-90,619,-44,-16,-673,1895,1222,109
109,John Collins,PF,ATL,678,-644,134,-169,64,422,196,132,224,-120,876,34,-35,-933,2726,1793,110
110,Zach Collins,C,SAS,152,-155,52,-65,14,153,122,52,92,-90,218,-3,-13,-310,855,545,111
111,Darren Collison,PG,LAL,4,-7,0,0,0,4,4,4,0,-2,4,-3,0,-9,20,11,112
112,Mike Conley,PG,UTA,688,-791,129,-162,169,217,770,384,84,-246,986,-103,-33,-1199,3427,2228,113
113,Pat Connaughton,SF,MIL,454,-496,45,-54,146,273,164,236,60,-70,645,-42,-9,-620,2023,1403,114
114,Tyler Cook,PF,CHI,46,-38,21,-32,0,53,6,16,16,-14,67,8,-11,-84,225,141,115
115,Sharife Cooper,PG,ATL,6,-14,0,0,1,5,10,0,0,-10,7,-8,0,-24,29,5,116
116,Petr Cornelie,PF,DEN,10,-15,3,-4,1,14,6,4,4,-8,14,-5,-1,-27,56,29,117
117,DeMarcus Cousins,C,TOT,298,-324,95,-125,37,270,142,140,84,-170,430,-26,-30,-619,1496,877,118
118,Robert Covington,PF,TOT,418,-498,58,-69,128,391,184,412,364,-150,604,-80,-11,-717,2559,1842,119
119,Torrey Craig,SF,TOT,400,-441,39,-52,77,310,182,184,144,-134,516,-41,-13,-627,1852,1225,120
120,Jae Crowder,PF,PHO,434,-544,71,-90,127,354,248,380,120,-110,632,-110,-19,-744,2366,1622,121
121,Jarrett Culver,SG,MEM,102,-135,16,-34,12,48,66,80,20,-40,130,-33,-18,-209,474,265,122
122,Jarron Cumberland,SG,POR,2,-2,0,0,0,3,2,0,0,0,2,0,0,-2,9,7,123
123,Cade Cunningham,SG,DET,858,-1031,142,-168,114,354,712,312,172,-468,1114,-173,-26,-1667,3778,2111,124
124,Seth Curry,SG,TOT,720,-739,82,-94,158,200,460,212,56,-218,960,-19,-12,-1051,2848,1797,125
125,Stephen Curry,PG,GSW,1070,-1224,275,-298,285,335,808,340,92,-412,1630,-154,-23,-1934,4835,2901,126
126,Anthony Davis,C,LAL,740,-695,174,-244,13,394,244,196,360,-164,927,45,-70,-1103,3048,1945,127
127,Ed Davis,C,CLE,22,-16,6,-14,0,64,14,12,36,-10,28,6,-8,-40,182,142,128
128,Terence Davis,SG,SAC,226,-267,36,-44,49,94,80,100,44,-66,311,-41,-8,-377,940,563,129
129,Gabriel Deck,PF,OKC,16,-14,0,0,2,6,10,4,0,-4,18,2,0,-18,56,38,130
130,Dewayne Dedmon,C,MIA,328,-290,75,-100,19,386,94,96,168,-140,422,38,-25,-530,1588,1058,131
131,Sam Dekker,PF,TOR,0,0,0,0,0,0,0,0,0,0,0,0,0,0,0,0,132
132,Javin DeLaurier,C,MIL,0,0,0,0,0,1,0,4,0,0,0,0,0,0,5,5,133
133,DeMar DeRozan,PF,CHI,1548,-1535,520,-593,50,392,748,272,96,-362,2118,13,-73,-2490,5744,3254,134
134,Mamadi Diakite,PF,OKC,50,-47,6,-11,0,59,4,20,36,-14,56,3,-5,-72,231,159,135
135,Cheick Diallo,C,DET,6,-8,5,-6,0,12,0,4,0,-2,11,-2,-1,-16,38,22,136
136,Hamidou Diallo,SG,DET,522,-526,91,-140,23,277,146,284,68,-116,636,-4,-49,-782,2047,1265,137
137,Gorgui Dieng,C,ATL,106,-112,19,-26,29,121,68,44,52,-40,154,-6,-7,-178,593,415,138
138,Spencer Dinwiddie,PG-SG,TOT,612,-735,195,-252,112,279,692,176,52,-208,919,-123,-57,-1195,3037,1842,139
139,Donte DiVincenzo,SG,TOT,236,-336,70,-83,74,170,236,192,32,-144,380,-100,-13,-563,1390,827,140
140,Luka Dončić,PG,DAL,1282,-1403,364,-489,201,593,1136,300,144,-584,1847,-121,-125,-2476,5867,3391,141
141,Luguentz Dort,SG,OKC,586,-726,161,-191,130,212,176,184,72,-176,877,-140,-30,-1093,2398,1305,142
142,Ayo Dosunmu,SG,CHI,556,-535,53,-78,70,214,512,240,116,-216,679,21,-25,-829,2440,1611,143
143,Damyean Dotson,SG,NYK,4,-4,0,0,0,2,2,0,0,0,4,0,0,-4,12,8,144
144,Devon Dotson,PG,CHI,22,-23,5,-9,2,9,30,4,0,-10,29,-1,-4,-42,101,59,145
145,Sekou Doumbouya,PF,LAL,10,-8,3,-4,1,6,0,12,8,-4,14,2,-1,-16,54,38,146
146,Jeff Dowtin,PG,TOT,16,-26,2,-2,1,18,20,20,4,-10,19,-10,0,-38,100,62,147
147,PJ Dozier,SG,DEN,72,-99,10,-13,15,63,58,44,24,-26,97,-27,-3,-138,383,245,148
148,Goran Dragić,PG,TOT,114,-151,27,-33,16,65,172,76,16,-68,157,-37,-6,-252,643,391,149
149,Andre Drummond,C,TOT,494,-433,86,-164,0,680,262,312,272,-230,580,61,-78,-827,2686,1859,150
150,Chris Duarte,SG,IND,536,-621,90,-112,94,226,228,224,40,-180,720,-85,-22,-913,2158,1245,151
151,David Duke Jr.,PG,BRK,78,-108,17,-21,9,67,34,56,28,-18,104,-30,-4,-147,393,246,152
152,Kris Dunn,PG,POR,88,-102,17,-18,1,49,158,92,12,-64,106,-14,-1,-184,523,339,153
153,Kevin Durant,PF,BRK,1156,-1115,372,-409,115,407,702,192,208,-382,1643,41,-37,-1906,4795,2889,154
154,Jaime Echenique,C,WAS,0,0,0,0,0,0,0,0,0,0,0,0,0,0,0,0,155
155,Anthony Edwards,SG,MIN,1098,-1245,220,-280,215,343,550,420,184,-380,1533,-147,-60,-1905,4563,2658,156
156,Carsen Edwards,SG,DET,18,-30,1,-1,4,6,28,8,0,-10,23,-12,0,-41,88,47,157
157,Kessler Edwards,SF,BRK,220,-267,16,-19,48,172,62,116,96,-84,284,-47,-3,-370,1014,644,158
158,Rob Edwards,SG,OKC,2,-4,0,0,1,3,0,0,0,-2,3,-2,0,-6,9,3,159
159,CJ Elleby,SF,POR,242,-308,60,-84,37,227,174,140,76,-112,339,-66,-24,-504,1295,791,160
160,Wayne Ellington,SG,LAL,196,-237,9,-11,82,77,60,92,20,-38,287,-41,-2,-286,823,537,161
161,Joel Embiid,C,PHI,1332,-1334,654,-803,93,796,568,308,396,-428,2079,-2,-149,-2565,6226,3661,162
162,James Ennis III,SF,TOT,22,-24,4,-5,3,12,6,8,8,-4,29,-2,-1,-33,92,59,163
163,Drew Eubanks,C,TOT,442,-371,99,-130,5,382,170,124,160,-162,546,71,-31,-663,1928,1265,164
164,Tacko Fall,C,CLE,10,-12,2,-7,0,23,4,0,24,-6,12,-2,-5,-25,75,50,165
165,Derrick Favors,C,OKC,188,-182,16,-25,2,184,50,68,48,-18,206,6,-9,-225,762,537,166
166,Bruno Fernando,C,TOT,72,-55,15,-24,1,55,14,4,44,-28,88,17,-9,-107,293,186,167
167,Dorian Finney-Smith,PF,DAL,652,-692,56,-83,172,375,300,352,156,-160,880,-40,-27,-935,2943,2008,168
168,Malik Fitts,PF,TOT,16,-19,0,0,5,17,10,0,0,-4,21,-3,0,-23,69,46,169
169,Malachi Flynn,PG,TOR,144,-183,15,-24,30,63,140,80,16,-26,189,-39,-9,-233,677,444,170
170,Bryn Forbes,SG,TOT,462,-539,79,-87,122,93,150,100,20,-112,663,-77,-8,-738,1689,951,171
171,Aleem Ford,SF,ORL,12,-20,0,0,2,15,4,4,0,-8,14,-8,0,-28,51,23,172
172,Trent Forrest,PG,UTA,152,-155,38,-48,5,99,212,120,24,-96,195,-3,-10,-299,845,546,173
173,Evan Fournier,SG,NYK,804,-965,80,-113,241,210,342,316,80,-210,1125,-161,-33,-1288,3198,1910,174
174,De'Aaron Fox,PG,SAC,1032,-1092,261,-348,74,231,660,272,100,-336,1367,-60,-87,-1776,3997,2221,175
175,Melvin Frazier,SG,OKC,26,-48,5,-7,1,13,2,4,0,-6,32,-22,-2,-61,83,22,176
176,Tim Frazier,PG,TOT,28,-45,5,-9,6,19,68,12,4,-30,39,-17,-4,-84,181,97,177
177,Enes Freedom,C,BOS,102,-97,24,-28,2,160,16,20,56,-40,128,5,-4,-165,508,343,178
178,Markelle Fultz,PG,ORL,166,-175,25,-31,4,49,198,80,20,-80,195,-9,-6,-286,737,451,179
179,Wenyen Gabriel,PF,TOT,108,-110,25,-42,8,97,28,20,44,-32,141,-2,-17,-184,471,287,180
180,Daniel Gafford,C,WAS,570,-411,107,-153,0,407,136,120,396,-130,677,159,-46,-694,2413,1719,181
181,Danilo Gallinari,PF,ATL,518,-597,141,-156,112,308,202,112,48,-76,771,-79,-15,-829,2212,1383,182
182,Langston Galloway,SG,TOT,12,-26,0,0,2,18,24,4,0,-12,14,-14,0,-38,74,36,183
183,Darius Garland,PG,CLE,1084,-1173,215,-241,174,224,1166,356,28,-496,1473,-89,-26,-1910,4720,2810,184
184,Marcus Garrett,SG,MIA,10,-21,2,-5,1,23,14,20,12,-4,13,-11,-3,-30,95,65,185
185,Usman Garuba,PF,HOU,38,-44,5,-7,5,83,34,40,44,-12,48,-6,-2,-63,297,234,186
186,Luka Garza,C,DET,132,-147,38,-61,16,100,40,36,24,-36,186,-15,-23,-244,572,328,187
187,Rudy Gay,PF,UTA,314,-379,62,-79,70,242,112,100,76,-94,446,-65,-17,-552,1422,870,188
188,Paul George,PF,LAC,536,-636,127,-148,91,213,352,268,52,-252,754,-100,-21,-1036,2393,1357,189
189,Taj Gibson,C,NYK,172,-166,42,-52,15,229,64,88,160,-54,229,6,-10,-272,999,727,190
190,Josh Giddey,SF,OKC,562,-670,56,-79,56,421,690,204,80,-342,674,-108,-23,-1091,2743,1652,191
191,Shai Gilgeous-Alexander,PG,OKC,954,-1052,328,-405,89,278,662,284,184,-308,1371,-98,-77,-1765,4150,2385,192
192,Anthony Gill,PF,WAS,124,-109,42,-52,14,85,54,20,44,-36,180,15,-10,-197,563,366,193
193,Freddie Gillespie,PF,ORL,18,-22,3,-7,0,36,10,12,36,-10,21,-4,-4,-39,136,97,194
194,Rudy Gobert,C,UTA,724,-508,303,-439,0,968,144,180,548,-238,1027,216,-136,-1185,3894,2709,195
195,Brandon Goodwin,PG,CLE,128,-154,24,-38,19,67,182,100,4,-72,171,-26,-14,-264,695,431,196
196,Jordan Goodwin,SG,WAS,0,-3,0,0,0,1,0,0,0,0,0,-3,0,-3,1,-2,197
197,Aaron Gordon,PF,DEN,868,-834,171,-230,87,439,376,176,176,-266,1126,34,-59,-1330,3419,2089,198
198,Eric Gordon,SG,HOU,536,-564,105,-135,124,113,308,112,72,-214,765,-28,-30,-913,2135,1222,199
199,Devonte' Graham,PG,NOP,592,-815,118,-140,192,177,632,284,48,-210,902,-223,-22,-1165,2945,1780,200
200,Jerami Grant,PF,DET,596,-699,217,-259,91,191,222,176,196,-170,904,-103,-42,-1128,2593,1465,201
201,Hassani Gravett,PG,ORL,36,-38,3,-4,11,21,40,20,4,-18,50,-2,-1,-60,185,125,202
202,Danny Green,SF,PHI,252,-320,11,-14,103,157,128,240,148,-90,366,-68,-3,-424,1405,981,203
203,Draymond Green,PF,GSW,270,-257,60,-91,16,336,640,244,200,-278,346,13,-31,-626,2112,1486,204
204,Jalen Green,SG,HOU,812,-954,188,-236,157,226,352,176,72,-270,1157,-142,-48,-1460,3140,1680,205
205,JaMychal Green,PF,DEN,318,-327,81,-93,33,281,118,172,104,-114,432,-9,-12,-534,1539,1005,206
206,Javonte Green,SF,CHI,352,-325,80,-96,36,276,120,268,128,-60,468,27,-16,-481,1728,1247,207
207,Jeff Green,PF,DEN,554,-529,165,-198,53,231,192,112,108,-142,772,25,-33,-869,2187,1318,208
208,Josh Green,SG,DAL,260,-256,31,-45,28,161,158,180,56,-88,319,4,-14,-389,1193,804,209
209,Blake Griffin,C,BRK,266,-313,55,-76,38,228,210,108,56,-62,359,-47,-21,-451,1320,869,210
210,Quentin Grimes,SG,NYK,190,-235,13,-19,72,94,88,124,44,-56,275,-45,-6,-310,900,590,211
211,Kyle Guy,SG,MIA,52,-65,8,-12,14,17,34,28,4,-26,74,-13,-4,-103,231,128,212
212,Rui Hachimura,PF,WAS,374,-381,46,-66,55,160,96,92,36,-66,475,-7,-20,-513,1334,821,213
213,Tyrese Haliburton,SG-PG,TOT,860,-909,160,-190,161,311,1256,536,196,-398,1181,-49,-30,-1497,4661,3164,214
214,Tyler Hall,SG,NYK,0,0,0,0,0,0,0,0,0,0,0,0,0,0,0,0,215
215,R.J. Hampton,SG,ORL,350,-457,75,-117,64,194,316,168,52,-174,489,-107,-42,-748,1708,960,216
216,Tim Hardaway Jr.,SG,DAL,418,-530,78,-103,102,156,184,152,24,-68,598,-112,-25,-701,1712,1011,217
217,James Harden,PG,TOT,814,-992,470,-536,148,500,1334,328,144,-568,1432,-178,-66,-2096,5170,3074,218
218,Maurice Harkless,SF,SAC,166,-181,20,-28,31,112,46,116,96,-62,217,-15,-8,-271,804,533,219
219,Jared Harper,PG,NOP,28,-26,4,-4,5,2,28,16,4,-4,37,2,0,-34,124,90,220
220,Montrezl Harrell,C,TOT,716,-555,212,-296,4,431,290,116,172,-144,932,161,-84,-995,2873,1878,221
221,Gary Harris,SG,ORL,480,-553,83,-95,116,122,216,236,36,-122,679,-73,-12,-770,1968,1198,222
222,Joe Harris,SF,BRK,112,-124,5,-6,41,56,28,28,8,-32,158,-12,-1,-162,436,274,223
223,Tobias Harris,PF,PHI,986,-1022,170,-202,101,496,504,188,172,-232,1257,-36,-32,-1456,3874,2418,224
224,Shaquille Harrison,SG,BRK,4,-6,0,0,0,4,6,4,4,-4,4,-2,0,-10,26,16,225
225,Josh Hart,SG,TOT,574,-569,160,-211,73,388,448,244,52,-228,807,5,-51,-1008,2746,1738,226
226,Isaiah Hartenstein,C,LAC,458,-366,91,-132,14,332,320,200,308,-168,563,92,-41,-666,2286,1620,227
227,Udonis Haslem,C,MIA,28,-31,3,-3,1,25,8,4,4,-10,32,-3,0,-44,105,61,228
228,Sam Hauser,SF,BOS,46,-50,0,0,19,29,20,4,8,-4,65,-4,0,-54,191,137,229
229,Jaxson Hayes,C,NOP,490,-398,144,-188,20,315,86,132,220,-108,654,92,-44,-694,2061,1367,230
230,Killian Hayes,PG,DET,352,-459,57,-74,44,210,554,312,140,-222,453,-107,-17,-755,2122,1367,231
231,Gordon Hayward,SF,CHO,566,-617,126,-149,86,224,354,188,88,-162,778,-51,-23,-928,2410,1482,232
232,Aaron Henry,SF,PHI,2,-5,0,0,0,1,0,0,8,-4,2,-3,0,-9,13,4,233
233,Juancho Hernangómez,PF,TOT,88,-106,19,-34,24,100,40,56,40,-32,131,-18,-15,-172,498,326,234
234,Willy Hernangómez,C,NOP,340,-327,109,-141,4,338,126,84,76,-102,453,13,-32,-570,1530,960,235
235,Tyler Herro,SG,MIA,1002,-1122,190,-219,175,329,526,176,32,-348,1367,-120,-29,-1689,3797,2108,236
236,Buddy Hield,SG,TOT,892,-1098,111,-127,262,353,458,292,100,-306,1265,-206,-16,-1531,3733,2202,237
237,Haywood Highsmith,SF,MIA,32,-46,2,-5,9,26,12,8,12,-6,43,-14,-3,-57,144,87,238
238,George Hill,PG,MIL,236,-275,57,-62,41,155,240,168,24,-82,334,-39,-5,-419,1255,836,239
239,Malcolm Hill,SF-SG,TOT,48,-52,11,-14,13,35,16,28,12,-6,72,-4,-3,-72,235,163,240
240,Solomon Hill,SF,ATL,6,-20,0,0,2,23,24,16,8,-2,8,-14,0,-22,87,65,241
241,Nate Hinton,SG,IND,0,-1,0,0,0,0,0,0,0,-2,0,-1,0,-3,0,-3,242
242,Jaylen Hoard,SF,OKC,88,-90,6,-14,9,84,34,24,20,-16,103,-2,-8,-120,368,248,243
243,Aaron Holiday,PG,TOT,302,-338,59,-68,39,122,306,168,36,-134,400,-36,-9,-540,1432,892,244
244,Jrue Holiday,PG,MIL,956,-954,137,-180,132,301,914,432,116,-366,1225,2,-43,-1500,4213,2713,245
245,Justin Holiday,SF-SG,TOT,522,-662,50,-62,177,190,256,228,132,-140,749,-140,-12,-864,2304,1440,246
246,Richaun Holmes,C,SAC,396,-300,70,-90,2,317,96,68,164,-112,468,96,-20,-502,1581,1079,247
247,Rodney Hood,PF-SF,TOT,116,-157,17,-19,30,77,76,60,24,-22,163,-41,-2,-198,563,365,248
248,Scotty Hopson,SG,OKC,4,-4,0,0,0,1,2,0,0,-4,4,0,0,-8,11,3,249
249,Al Horford,C,BOS,532,-569,80,-95,89,530,464,196,368,-130,701,-37,-15,-794,2960,2166,250
250,Talen Horton-Tucker,SG,LAL,448,-538,100,-125,49,193,318,236,116,-164,597,-90,-25,-827,2057,1230,251
251,Danuel House Jr.,SF,TOT,160,-198,44,-58,44,111,88,84,68,-66,248,-38,-14,-322,847,525,252
252,Dwight Howard,C,LAL,268,-219,96,-146,8,356,70,136,144,-94,372,49,-50,-459,1450,991,253
253,Markus Howard,SG,DEN,78,-101,20,-23,28,12,14,36,0,-14,126,-23,-3,-138,314,176,254
254,Kevin Huerter,SF,ATL,690,-760,42,-52,160,254,406,220,104,-182,892,-70,-10,-994,2768,1774,255
255,Jay Huff,C,LAL,0,-3,0,0,0,4,2,4,4,-2,0,-3,0,-5,14,9,256
256,Elijah Hughes,SG-SF,TOT,94,-144,7,-9,25,58,44,56,32,-34,126,-50,-2,-187,442,255,257
257,Feron Hunt,SF,NYK,0,-2,0,0,0,1,2,4,0,-2,0,-2,0,-4,7,3,258
258,De'Andre Hunter,SF,ATL,508,-575,127,-166,74,176,136,144,84,-138,709,-67,-39,-879,1958,1079,259
259,Chandler Hutchison,SF,PHO,2,-2,2,-2,0,5,4,0,0,-8,4,0,0,-12,17,5,260
260,Bones Hyland,SG,DEN,460,-571,107,-125,131,188,382,164,80,-172,698,-111,-18,-868,2210,1342,261
261,Serge Ibaka,C,TOT,296,-296,32,-44,37,250,98,44,132,-86,365,0,-12,-426,1254,828,262
262,Andre Iguodala,SF,GSW,92,-121,15,-20,17,100,228,108,88,-56,124,-29,-5,-197,772,575,263
263,Joe Ingles,SF,UTA,230,-285,17,-22,78,131,316,92,20,-92,325,-55,-5,-399,1209,810,264
264,Brandon Ingram,SF,NOP,906,-983,266,-322,74,320,614,136,104,-302,1246,-77,-56,-1607,3666,2059,265
265,Kyrie Irving,PG,BRK,578,-616,118,-129,100,127,334,164,68,-146,796,-38,-11,-891,2285,1394,266
266,Wes Iwundu,SF,ATL,16,-18,3,-4,3,13,0,4,0,-2,22,-2,-1,-24,61,37,267
267,Frank Jackson,PG,DET,388,-483,86,-104,86,87,110,108,36,-76,560,-95,-18,-663,1461,798,268
268,Isaiah Jackson,PF,IND,232,-206,60,-88,5,149,20,100,208,-80,297,26,-28,-374,1071,697,269
269,Jaren Jackson Jr.,PF,MEM,860,-1036,284,-345,128,454,172,292,708,-260,1272,-176,-61,-1641,4170,2529,270
270,Josh Jackson,SF,TOT,240,-300,55,-77,33,141,108,104,88,-94,328,-60,-22,-471,1097,626,271
271,Justin Jackson,SF,TOT,10,-15,2,-2,3,7,4,0,0,-2,15,-5,0,-19,41,22,272
272,Reggie Jackson,SG,LAC,958,-1222,138,-163,167,271,718,220,60,-346,1263,-264,-25,-1731,3795,2064,273
273,LeBron James,PF,LAL,1280,-1221,254,-336,161,459,698,292,236,-392,1695,59,-82,-1949,5075,3126,274
274,DeJon Jarreau,SG,IND,0,0,0,0,0,0,0,0,0,0,0,0,0,0,0,0,275
275,DaQuan Jeffries,SG,MEM,2,-2,0,0,0,2,2,0,0,0,2,0,0,-2,8,6,276
276,Ty Jerome,SG,OKC,248,-328,38,-47,54,78,218,120,20,-74,340,-80,-9,-449,1116,667,277
277,Isaiah Joe,SG,PHI,124,-177,29,-31,45,56,70,56,12,-38,198,-53,-2,-246,590,344,278
278,Alize Johnson,PF,TOT,34,-39,7,-12,0,61,18,20,0,-24,41,-5,-5,-75,181,106,279
279,B.J. Johnson,SF,ORL,22,-25,0,0,4,15,0,0,4,0,26,-3,0,-25,71,46,280
280,Cameron Johnson,PF,PHO,558,-607,98,-114,166,273,198,228,64,-94,822,-49,-16,-815,2407,1592,281
281,David Johnson,SG,TOR,0,-1,0,0,0,0,0,0,0,0,0,-1,0,-1,0,-1,282
282,Jalen Johnson,PF,ATL,44,-41,5,-7,3,26,6,12,8,-18,52,3,-2,-66,156,90,283
283,James Johnson,PF,BRK,288,-307,29,-55,23,215,260,120,136,-96,340,-19,-26,-458,1411,953,284
284,Joe Johnson,SG,BOS,2,-1,0,0,0,0,0,0,0,0,2,1,0,-1,4,3,285
285,Keldon Johnson,SF,SAS,942,-1011,177,-234,159,457,316,232,56,-184,1278,-69,-57,-1429,3617,2188,286
286,Keon Johnson,SG,TOT,192,-272,41,-51,34,81,152,112,48,-92,267,-80,-10,-415,927,512,287
287,Stanley Johnson,PF,LAL,234,-251,53,-74,33,155,160,172,56,-70,320,-17,-21,-395,1183,788,288
288,Tyler Johnson,PG,TOT,12,-20,0,0,5,12,14,12,12,-4,17,-8,0,-24,84,60,289
289,Nikola Jokić,C,DEN,1528,-1311,379,-468,97,1019,1168,436,252,-562,2004,217,-89,-2341,6883,4542,290
290,Carlik Jones,PG,TOT,2,-9,2,-2,0,3,10,4,0,-6,4,-7,0,-17,25,8,291
291,Damian Jones,C,SAC,350,-266,94,-131,10,246,138,104,188,-118,454,84,-37,-515,1584,1069,292
292,Derrick Jones Jr.,PF,CHI,210,-195,56,-70,20,169,60,100,132,-60,286,15,-14,-325,1033,708,293
293,Herbert Jones,PF,NOP,548,-576,137,-163,57,296,334,520,240,-200,742,-28,-26,-939,2874,1935,294
294,Jemerrio Jones,SF,LAL,4,-3,0,0,0,3,0,4,0,0,4,1,0,-3,15,12,295
295,Kai Jones,C,CHO,18,-14,3,-8,1,11,8,4,8,-12,22,4,-5,-34,75,41,296
296,Mason Jones,SG,LAL,14,-15,12,-15,1,10,8,8,0,-2,27,-1,-3,-32,80,48,297
297,Tre Jones,PG,SAS,332,-339,71,-91,10,155,466,168,28,-92,413,-7,-20,-522,1643,1121,298
298,Tyus Jones,PG,MEM,498,-552,54,-66,80,176,648,264,8,-92,632,-54,-12,-710,2360,1650,299
299,DeAndre Jordan,C,TOT,184,-143,22,-40,0,264,42,48,140,-74,206,41,-18,-257,906,649,300
300,Cory Joseph,PG,DET,356,-400,100,-113,65,174,474,168,68,-170,521,-44,-13,-683,1926,1243,301
301,Georgios Kalaitzakis,SF,TOT,62,-67,14,-30,10,21,24,44,8,-40,86,-5,-16,-137,269,132,302
302,Frank Kaminsky,C,PHO,72,-66,18,-20,5,41,26,32,28,-10,95,6,-2,-96,317,221,303
303,Luke Kennard,SG,LAC,574,-639,69,-77,190,229,292,168,24,-120,833,-65,-8,-836,2379,1543,304
304,Braxton Key,SF,TOT,66,-72,7,-13,6,50,22,40,44,-22,79,-6,-6,-107,314,207,305
305,George King,SF,DAL,0,-5,1,-2,0,5,0,0,0,-2,1,-5,-1,-9,7,-2,306
306,Louis King,SF,SAC,30,-47,7,-10,8,12,18,8,4,0,45,-17,-3,-57,132,75,307
307,Corey Kispert,SF,WAS,468,-514,54,-62,112,209,170,140,88,-100,634,-46,-8,-676,1875,1199,308
308,Maxi Kleber,PF,DAL,282,-354,46,-65,83,350,136,120,232,-94,411,-72,-19,-513,1660,1147,309
309,Brandon Knight,PG,DAL,20,-25,8,-8,4,8,16,4,0,-8,32,-5,0,-41,92,51,310
310,Nathan Knight,PF,MIN,90,-88,44,-60,4,85,44,28,32,-36,138,2,-16,-184,465,281,311
311,Kevin Knox,SF,TOT,62,-85,16,-22,15,44,20,16,8,-14,93,-23,-6,-121,274,153,312
312,John Konchar,SG,MEM,270,-262,27,-49,52,329,218,180,88,-58,349,8,-22,-369,1513,1144,313
313,Furkan Korkmaz,SG,PHI,364,-470,68,-84,77,175,254,132,36,-96,509,-106,-16,-650,1615,965,314
314,Luke Kornet,C,TOT,26,-27,4,-6,0,29,18,12,12,0,30,-1,-2,-33,131,98,315
315,Vit Krejci,SG,OKC,136,-167,19,-22,32,101,114,76,32,-58,187,-31,-3,-247,697,450,316
316,Arnoldas Kulboka,SF,CHO,0,-1,0,0,0,0,0,0,0,0,0,-1,0,-1,0,-1,317
317,Jonathan Kuminga,SF,GSW,472,-460,130,-190,50,234,128,124,88,-148,652,12,-60,-798,1878,1080,318
318,Kyle Kuzma,PF,WAS,846,-936,156,-219,128,561,466,168,228,-338,1130,-90,-63,-1493,3683,2190,319
319,Anthony Lamb,SF,SAS,0,-2,0,0,0,1,4,0,0,0,0,-2,0,-2,5,3,320
320,Jeremy Lamb,SF-SG,TOT,266,-347,89,-106,55,154,162,124,88,-74,410,-81,-17,-527,1348,821,321
321,Jock Landale,C,SAS,202,-204,34,-41,29,138,90,40,56,-62,265,-2,-7,-307,854,547,322
322,Romeo Langford,SG,TOT,166,-191,23,-42,29,108,42,88,64,-32,218,-25,-19,-265,738,473,323
323,Zach LaVine,SG,CHI,1130,-1186,320,-375,185,308,606,164,92,-342,1635,-56,-55,-1903,4440,2537,324
324,Jake Layman,SF,MIN,60,-73,13,-18,8,36,18,28,20,-20,81,-13,-5,-111,264,153,325
325,Damion Lee,SG,GSW,338,-383,66,-75,63,203,126,156,24,-76,467,-45,-9,-534,1443,909,326
326,Saben Lee,PG,DET,138,-177,56,-71,14,87,214,144,48,-72,208,-39,-15,-320,909,589,327
327,Alex Len,C,SAC,188,-176,41,-63,6,161,90,52,100,-86,235,12,-22,-325,873,548,328
328,Caris LeVert,SG,TOT,758,-854,146,-193,82,214,496,204,92,-216,986,-96,-47,-1263,2978,1715,329
329,Kira Lewis Jr.,PG,NOP,118,-146,10,-12,13,39,98,44,4,-52,141,-28,-2,-210,467,257,330
330,Scottie Lewis,SG,CHO,0,0,1,-2,0,0,2,4,0,0,1,0,-1,-2,8,6,331
331,Damian Lillard,PG,POR,444,-552,159,-181,92,120,424,68,44,-166,695,-108,-22,-899,2046,1147,332
332,Nassir Little,SF,POR,290,-315,69,-94,51,236,108,100,144,-80,410,-25,-25,-489,1408,919,333
333,Isaiah Livers,SF,DET,82,-90,12,-14,27,57,42,52,28,-30,121,-8,-2,-134,421,287,334
334,Kevon Looney,C,GSW,416,-364,75,-125,0,596,330,200,208,-134,491,52,-50,-623,2316,1693,335
335,Brook Lopez,C,MIL,122,-131,20,-23,19,53,12,32,60,-24,161,-9,-3,-178,479,301,336
336,Robin Lopez,C,ORL,220,-199,32,-54,2,126,108,8,72,-88,254,21,-22,-341,822,481,337
337,Didi Louzada,SG-SF,TOT,24,-33,2,-2,9,17,10,8,8,-10,35,-9,0,-45,113,68,338
338,Kevin Love,C,CLE,654,-761,166,-198,187,536,320,104,72,-196,1007,-107,-32,-1155,3046,1891,339
339,Kyle Lowry,PG,MIA,552,-627,148,-174,144,282,948,268,68,-336,844,-75,-26,-1137,3254,2117,340
340,Gabriel Lundberg,SG,PHO,10,-19,0,0,3,7,22,12,0,-6,13,-9,0,-25,67,42,341
341,Timothé Luwawu-Cabarrot,SF,ATL,148,-186,35,-41,44,82,80,72,24,-40,227,-38,-6,-267,712,445,342
342,Trey Lyles,PF,TOT,524,-562,195,-243,67,379,176,116,128,-146,786,-38,-48,-951,2371,1420,343
343,Théo Maledon,PG,OKC,238,-317,79,-100,44,131,222,124,44,-130,361,-79,-21,-547,1243,696,344
344,Sandro Mamukelashvili,PF,MIL,114,-115,18,-22,22,82,44,36,36,-30,154,-1,-4,-167,506,339,345
345,Terance Mann,SF,LAC,668,-690,128,-164,76,425,418,220,84,-168,872,-22,-36,-1022,2891,1869,346
346,Tre Mann,PG,OKC,462,-588,65,-82,98,171,182,188,48,-142,625,-126,-17,-812,1839,1027,347
347,Boban Marjanović,C,DAL,84,-70,13,-22,1,39,6,0,12,-30,98,14,-9,-122,253,131,348
348,Lauri Markkanen,SF,CLE,626,-703,138,-159,136,345,162,180,120,-108,900,-77,-21,-970,2607,1637,349
349,Naji Marshall,SF,NOP,218,-269,74,-93,21,142,124,132,32,-92,313,-51,-19,-454,1056,602,350
350,Caleb Martin,SF,MIA,416,-410,71,-93,64,230,128,232,120,-104,551,6,-22,-607,1812,1205,351
351,Cody Martin,SF,CHO,408,-423,75,-107,61,285,358,352,128,-122,544,-15,-32,-652,2211,1559,352
352,Kelan Martin,SF,TOT,140,-171,9,-13,22,55,42,52,36,-28,171,-31,-4,-212,527,315,353
353,Kenyon Martin Jr.,SF,HOU,558,-523,78,-123,60,297,202,136,160,-120,696,35,-45,-766,2187,1421,354
354,Garrison Mathews,SG,HOU,368,-461,143,-180,139,190,128,228,96,-82,650,-93,-37,-723,1942,1219,355
355,Dakota Mathias,SG,MEM,4,-6,0,0,2,2,2,4,0,0,6,-2,0,-6,20,14,356
356,Wesley Matthews,SG,MIL,174,-220,22,-28,53,92,72,92,32,-36,249,-46,-6,-284,786,502,357
357,Tyrese Maxey,PG,PHI,966,-995,213,-246,132,240,642,220,128,-176,1311,-29,-33,-1417,3852,2435,358
358,Skylar Mays,SG,ATL,64,-64,8,-9,8,25,34,28,0,-20,80,0,-1,-93,247,154,359
359,Miles McBride,PG,NYK,64,-108,8,-12,17,42,82,56,4,-10,89,-44,-4,-130,362,232,360
360,Mac McClung,SG-PG,TOT,6,-6,1,-1,1,3,2,4,4,-6,8,0,0,-13,29,16,361
361,CJ McCollum,SG,TOT,1072,-1164,116,-170,182,269,630,280,88,-254,1370,-92,-54,-1588,4007,2419,362
362,T.J. McConnell,PG,IND,200,-208,19,-23,10,90,262,116,40,-58,229,-8,-4,-289,966,677,363
363,Jaden McDaniels,PF,MIN,510,-554,57,-71,80,293,158,208,216,-150,647,-44,-14,-775,2169,1394,364
364,Jalen McDaniels,SF,CHO,246,-254,53,-72,41,170,116,104,88,-72,340,-8,-19,-398,1158,760,365
365,Doug McDermott,PF,SAS,430,-465,40,-51,108,115,128,52,24,-86,578,-35,-11,-602,1475,873,366
366,JaVale McGee,C,PHO,576,-458,102,-146,2,496,84,88,324,-196,680,118,-44,-800,2352,1552,367
367,Cameron McGriff,SF,POR,10,-14,2,-2,2,15,6,0,4,0,14,-4,0,-16,53,37,368
368,Rodney McGruder,SG,DET,196,-225,19,-26,58,111,96,84,28,-48,273,-29,-7,-299,865,566,369
369,Alfonzo McKinnie,SF,CHI,48,-61,2,-8,9,33,10,8,12,-14,59,-13,-6,-83,181,98,370
370,JaQuori McLaughlin,PG,DAL,0,-2,0,0,0,0,4,0,0,0,0,-2,0,-2,4,2,371
371,Jordan McLaughlin,PG,MIN,176,-200,30,-40,27,94,360,228,40,-76,233,-24,-10,-316,1188,872,372
372,Ben McLemore,SG,POR,432,-539,72,-88,151,103,118,152,40,-110,655,-107,-16,-737,1723,986,373
373,De'Anthony Melton,SG,MEM,562,-695,90,-120,139,328,388,416,156,-224,791,-133,-30,-1039,2870,1831,374
374,Sam Merrill,SG,MEM,16,-24,2,-4,7,7,8,0,0,-4,25,-8,-2,-32,65,33,375
375,Chimezie Metu,C,SAC,406,-449,71,-91,57,335,120,204,128,-122,534,-43,-20,-662,1855,1193,376
376,Khris Middleton,SF,MIL,904,-1021,259,-291,162,356,716,304,72,-380,1325,-117,-32,-1692,4098,2406,377
377,C.J. Miles,SG,BOS,0,0,0,0,0,0,0,0,0,0,0,0,0,0,0,0,378
378,Patty Mills,SG,BRK,648,-794,48,-59,227,156,366,204,68,-146,923,-146,-11,-999,2640,1641,379
379,Paul Millsap,C,TOT,90,-115,17,-24,8,114,58,40,52,-38,115,-25,-7,-177,494,317,380
380,Shake Milton,SG,PHI,346,-403,61,-73,43,142,278,112,68,-88,450,-57,-12,-564,1500,936,381
381,Davion Mitchell,PG,SAC,704,-843,56,-85,101,166,626,220,96,-228,861,-139,-29,-1156,2830,1674,382
382,Donovan Mitchell,SG,UTA,1234,-1376,267,-313,232,282,716,396,48,-400,1733,-142,-46,-2089,4908,2819,383
383,Evan Mobley,PF,CLE,844,-830,167,-252,23,570,348,224,460,-266,1034,14,-85,-1348,3670,2322,384
384,Malik Monk,SG,LAL,782,-826,93,-117,173,256,436,244,116,-244,1048,-44,-24,-1187,3148,1961,385
385,Greg Monroe,C,TOT,64,-57,12,-23,0,64,44,32,40,-24,76,7,-11,-104,332,228,386
386,Moses Moody,SG,GSW,160,-183,28,-36,40,80,46,28,40,-26,228,-23,-8,-245,650,405,387
387,Xavier Moon,SG,LAC,50,-51,3,-5,5,14,48,28,12,-12,58,-1,-2,-68,218,150,388
388,Matt Mooney,SG,NYK,0,-1,0,0,0,0,0,4,0,-2,0,-1,0,-3,4,1,389
389,Ja Morant,PG,MEM,1160,-1177,316,-415,88,325,768,264,88,-392,1564,-17,-99,-1984,4573,2589,390
390,Juwan Morgan,PF,TOT,4,-3,0,0,1,4,2,0,0,0,5,1,0,-3,16,13,391
391,Jaylen Morris,SG,SAS,0,-6,2,-4,0,2,4,0,0,-2,2,-6,-2,-12,10,-2,392
392,Marcus Morris,PF,LAC,600,-691,129,-148,101,239,226,112,72,-138,830,-91,-19,-977,2309,1332,393
393,Markieff Morris,PF,MIA,108,-114,8,-9,13,45,46,24,4,-40,129,-6,-1,-163,377,214,394
394,Monte Morris,PG,DEN,748,-773,73,-84,124,226,666,224,56,-156,945,-25,-11,-1013,3062,2049,395
395,Emmanuel Mudiay,PG,SAC,0,-2,3,-4,0,0,8,4,0,-2,3,-2,-1,-8,18,10,396
396,Mychal Mulder,PG,TOT,48,-77,4,-4,17,24,10,16,8,-16,69,-29,0,-97,196,99,397
397,Ade Murkey,SG,SAC,0,0,0,0,0,0,0,0,0,0,0,0,0,0,0,0,398
398,Trey Murphy III,SF,NOP,218,-277,45,-51,71,147,76,92,28,-32,334,-59,-6,-360,1011,651,399
399,Dejounte Murray,PG,SAS,1146,-1241,196,-247,96,563,1254,552,92,-360,1438,-95,-51,-1848,5337,3489,400
400,Mike Muscala,C,OKC,226,-248,48,-57,70,129,44,72,104,-28,344,-22,-9,-333,1037,704,401
401,Svi Mykhailiuk,SF,TOR,182,-234,32,-37,41,92,90,104,16,-64,255,-52,-5,-335,812,477,402
402,Abdel Nader,SF,PHO,24,-35,6,-10,4,27,14,32,16,-22,34,-11,-4,-67,157,90,403
403,Larry Nance Jr.,C-PF,TOT,258,-247,40,-57,23,248,162,172,80,-74,321,11,-17,-378,1304,926,404
404,RJ Nembhard Jr.,SG,CLE,12,-18,3,-4,0,7,24,4,0,-6,15,-6,-1,-28,65,37,405
405,Aaron Nesmith,SF,BOS,144,-182,21,-26,31,89,44,80,20,-62,196,-38,-5,-270,625,355,406
406,Raul Neto,PG,WAS,408,-441,83,-108,35,134,434,220,12,-158,526,-33,-25,-707,1852,1145,407
407,Malik Newman,PG,CLE,6,-5,2,-2,0,1,2,0,0,-2,8,1,0,-9,19,10,408
408,Georges Niang,PF,PHI,492,-563,52,-59,156,203,204,120,52,-118,700,-71,-7,-740,1979,1239,409
409,Daishen Nix,SG,HOU,54,-67,16,-30,7,33,80,60,0,-52,77,-13,-14,-149,327,178,410
410,Zeke Nnaji,PF,DEN,192,-186,41,-65,37,147,34,64,52,-46,270,6,-24,-297,837,540,411
411,Nerlens Noel,C,NYK,64,-60,21,-30,0,141,46,120,124,-40,85,4,-9,-130,601,471,412
412,Jaylen Nowell,SG,MIN,392,-413,72,-92,63,123,260,108,40,-72,527,-21,-20,-577,1585,1008,413
413,Frank Ntilikina,SG,DAL,178,-223,24,-25,38,79,138,108,28,-62,240,-45,-1,-310,833,523,414
414,Jusuf Nurkić,C,POR,642,-600,185,-268,15,619,314,248,136,-286,842,42,-83,-1154,3001,1847,415
415,David Nwaba,SF,HOU,170,-176,48,-67,15,151,70,112,80,-42,233,-6,-19,-285,879,594,416
416,Jordan Nwora,SF,MIL,372,-462,36,-43,79,221,118,100,68,-114,487,-90,-7,-619,1481,862,417
417,Royce O'Neale,SF,UTA,406,-444,45,-56,119,368,382,344,128,-158,570,-38,-11,-658,2362,1704,418
418,Semi Ojeleye,PF,TOT,60,-99,23,-29,15,74,18,28,24,-18,98,-39,-6,-146,340,194,419
419,Chuma Okeke,PF,ORL,432,-575,55,-65,118,347,236,388,168,-114,605,-143,-10,-754,2349,1595,420
420,Josh Okogie,SG,MIN,84,-104,35,-51,14,70,50,104,48,-46,133,-20,-16,-201,538,337,421
421,Onyeka Okongwu,C,ATL,312,-226,80,-110,0,283,106,124,240,-88,392,86,-30,-424,1537,1113,422
422,Isaac Okoro,SF,CLE,414,-431,119,-155,55,201,242,224,88,-116,588,-17,-36,-702,1931,1229,423
423,KZ Okpala,PF,MIA,60,-69,8,-11,9,41,28,16,28,-10,77,-9,-3,-90,267,177,424
424,Victor Oladipo,SG,MIA,70,-73,14,-19,15,23,56,20,4,-32,99,-3,-5,-124,301,177,425
425,Cameron Oliver,SF,ATL,20,-15,2,-3,1,6,6,4,4,0,23,5,-1,-18,66,48,426
426,Kelly Olynyk,C,DET,256,-286,69,-89,40,177,222,124,76,-116,365,-30,-20,-491,1329,838,427
427,Eugene Omoruyi,SF,DAL,4,-5,2,-4,1,7,4,0,0,0,7,-1,-2,-9,25,16,428
428,Miye Oni,SG,UTA,4,-9,0,-1,1,7,10,0,0,-2,5,-5,-1,-12,27,15,429
429,Cedi Osman,SF,CLE,494,-572,87,-131,128,146,270,208,40,-134,709,-78,-44,-837,2082,1245,430
430,Daniel Oturu,C,TOR,6,-6,3,-5,0,5,0,0,8,0,9,0,-2,-11,31,20,431
431,Kelly Oubre Jr.,SF,CHO,820,-932,126,-189,191,302,168,308,124,-134,1137,-112,-63,-1255,3176,1921,432
432,Jaysean Paige,PG,DET,0,-3,0,0,0,1,2,0,0,-2,0,-3,0,-5,3,-2,433
433,Trayvon Palmer,SG,DET,0,-1,0,0,0,2,0,0,0,-2,0,-1,0,-3,2,-1,434
434,Kevin Pangos,PG,CLE,30,-46,3,-4,6,11,60,12,0,-14,39,-16,-1,-64,161,97,435
435,Jabari Parker,PF,BOS,36,-38,9,-9,8,28,12,16,4,-16,53,-2,0,-63,166,103,436
436,Eric Paschall,PF,UTA,228,-235,66,-86,40,106,72,36,20,-54,334,-7,-20,-375,902,527,437
437,Chris Paul,PG,PHO,726,-736,169,-202,63,283,1404,484,80,-306,958,-10,-33,-1244,4167,2923,438
438,Cameron Payne,PG,PHO,480,-587,75,-89,71,175,564,160,68,-206,626,-107,-14,-882,2219,1337,439
439,Elfrid Payton,PG,PHO,134,-175,12,-32,4,88,198,100,24,-94,150,-41,-20,-301,710,409,440
440,Gary Payton II,SG,GSW,424,-344,35,-58,43,247,128,384,88,-80,502,80,-23,-482,1851,1369,441
441,Norvel Pelle,C,UTA,6,-5,0,0,0,6,0,0,4,-4,6,1,0,-9,22,13,442
442,Reggie Perry,PF,TOT,80,-79,9,-15,3,47,24,36,24,-22,92,1,-6,-116,315,199,443
443,Jamorko Pickett,PF,DET,36,-50,1,-2,13,32,14,0,28,-10,50,-14,-1,-62,174,112,444
444,Theo Pinson,SF,DAL,28,-39,10,-10,10,21,34,20,8,-10,48,-11,0,-59,179,120,445
445,Mason Plumlee,C,CHO,410,-320,67,-171,0,565,452,244,208,-200,477,90,-104,-691,2423,1732,446
446,Jakob Poeltl,C,SAS,820,-663,94,-190,1,634,378,180,472,-218,915,157,-96,-1071,3494,2423,447
447,Aleksej Pokusevski,PF,OKC,372,-456,35,-50,57,318,262,156,152,-188,464,-84,-15,-694,1816,1122,448
448,Yves Pons,SF,MEM,10,-16,0,-2,3,12,2,4,16,-2,13,-6,-2,-20,60,40,449
449,Jordan Poole,SG,GSW,948,-1058,246,-266,211,260,608,240,92,-374,1405,-110,-20,-1698,4010,2312,450
450,Kevin Porter Jr.,PG,HOU,670,-808,124,-193,155,267,752,276,88,-384,949,-138,-69,-1385,3281,1896,451
451,Michael Porter Jr.,SF,DEN,74,-103,5,-9,10,59,34,40,8,-24,89,-29,-4,-136,319,183,452
452,Otto Porter Jr.,PF,GSW,386,-416,49,-61,80,362,188,272,116,-74,515,-30,-12,-551,1968,1417,453
453,Bobby Portis,C,MIL,834,-871,85,-113,133,657,172,212,204,-180,1052,-37,-28,-1164,3349,2185,454
454,Kristaps Porziņģis,PF,TOT,704,-767,248,-286,78,411,238,148,336,-162,1030,-63,-38,-1215,3193,1978,455
455,Micah Potter,C,DET,10,-11,2,-2,0,9,0,4,4,-2,12,-1,0,-15,41,26,456
456,Dwight Powell,C,DAL,538,-401,166,-212,13,404,194,148,156,-128,717,137,-46,-741,2336,1595,457
457,Myles Powell,PG,PHI,10,-17,2,-2,1,6,6,4,0,-6,13,-7,0,-25,42,17,458
458,Norman Powell,SF-SG,TOT,558,-605,189,-233,106,145,192,168,84,-138,853,-47,-44,-976,2295,1319,459
459,Joshua Primo,SF,SAS,202,-270,44,-59,42,113,162,80,92,-114,288,-68,-15,-443,1023,580,460
460,Taurean Prince,PF,MIN,354,-390,62,-82,86,174,136,188,92,-106,502,-36,-20,-578,1594,1016,461
461,Payton Pritchard,PG,BOS,320,-373,21,-21,101,134,278,100,24,-82,442,-53,0,-476,1420,944,462
462,Trevelin Queen,SG,HOU,30,-33,4,-4,9,16,8,20,4,-14,43,-3,0,-51,134,83,463
463,Neemias Queta,C,SAC,34,-38,11,-17,0,31,12,4,32,-12,45,-4,-6,-67,169,102,464
464,Immanuel Quickley,PG,NYK,568,-724,177,-201,137,247,550,216,12,-198,882,-156,-24,-1123,2789,1666,465
465,Jahmi'us Ramsey,SG,SAC,48,-58,7,-14,5,13,14,4,4,-10,60,-10,-7,-82,155,73,466
466,Julius Randle,PF,NYK,1024,-1246,303,-401,120,716,740,212,156,-490,1447,-222,-98,-2137,4718,2581,467
467,Austin Reaves,SG,LAL,292,-318,99,-118,53,193,220,116,80,-80,444,-26,-19,-516,1497,981,468
468,Cam Reddish,SF,TOT,330,-408,101,-112,66,105,96,188,60,-114,497,-78,-11,-634,1443,809,469
469,Davon Reed,SG,DEN,162,-161,10,-15,37,108,106,96,36,-32,209,1,-5,-208,764,556,470
470,Paul Reed,C,PHI,108,-96,6,-14,2,92,32,132,56,-20,116,12,-8,-130,544,414,471
471,Naz Reid,C,MIN,466,-476,114,-149,57,301,142,160,284,-164,637,-10,-35,-789,2161,1372,472
472,Nick Richards,C,CHO,120,-90,30,-43,0,86,26,36,84,-48,150,30,-13,-181,532,351,473
473,Josh Richardson,SG,TOT,468,-534,96,-108,102,185,230,224,116,-132,666,-66,-12,-774,2087,1313,474
474,Austin Rivers,SG,DEN,292,-350,32,-44,79,114,180,204,24,-108,403,-58,-12,-502,1328,826,475
475,Duncan Robinson,SG,MIA,580,-726,51,-61,232,203,258,168,56,-120,863,-146,-10,-907,2411,1504,476
476,Justin Robinson,PG,TOT,56,-93,4,-8,18,21,64,36,4,-34,78,-37,-4,-135,281,146,477
477,Mitchell Robinson,C,NYK,522,-343,88,-181,0,617,76,232,532,-120,610,179,-93,-644,2677,2033,478
478,Jeremiah Robinson-Earl,C,OKC,268,-324,40,-54,58,274,98,116,60,-78,366,-56,-14,-456,1280,824,479
479,Isaiah Roby,PF,OKC,332,-323,78,-116,44,217,142,144,136,-86,454,9,-38,-525,1547,1022,480
480,Rajon Rondo,PG,TOT,136,-176,19,-26,31,108,340,120,24,-136,186,-40,-7,-338,964,626,481
481,Derrick Rose,PG,NYK,244,-274,30,-31,37,78,206,88,48,-78,311,-30,-1,-383,1042,659,482
482,Terrence Ross,SG,ORL,440,-554,112,-130,77,161,232,112,48,-150,629,-114,-18,-834,1811,977,483
483,Terry Rozier,SG,CHO,1036,-1167,150,-176,222,315,652,372,100,-192,1408,-131,-26,-1535,4255,2720,484
484,Ricky Rubio,PG,CLE,298,-411,88,-103,59,141,450,196,28,-180,445,-113,-15,-694,1705,1011,485
485,D'Angelo Russell,PG,MIN,802,-975,198,-240,176,216,920,248,88,-330,1176,-173,-42,-1545,3824,2279,486
486,Matt Ryan,SF,BOS,2,-5,0,0,1,0,0,4,0,0,3,-3,0,-5,10,5,487
487,Domantas Sabonis,PF-C,TOT,886,-773,246,-332,39,752,646,236,108,-390,1171,113,-86,-1495,4084,2589,488
488,Olivier Sarr,C,OKC,116,-101,24,-29,13,93,38,24,60,-44,153,15,-5,-174,521,347,489
489,Tomáš Satoranský,SG-PG-SF,TOT,144,-191,43,-54,11,126,368,116,20,-92,198,-47,-11,-337,1026,689,490
490,Jordan Schakel,SG,WAS,2,-11,2,-2,1,8,0,4,0,-2,5,-9,0,-15,22,7,491
491,Admiral Schofield,SF,ORL,108,-129,12,-15,26,89,50,16,20,-42,146,-21,-3,-186,467,281,492
492,Dennis Schröder,SG-PG,TOT,624,-724,157,-184,86,214,592,212,32,-286,867,-100,-27,-1194,2784,1590,493
493,Tre Scott,SF,CLE,6,-6,0,0,0,2,0,4,4,0,6,0,0,-6,22,16,494
494,Jay Scrubb,SG,LAC,36,-46,7,-10,6,16,16,16,12,-14,49,-10,-3,-70,158,88,495
495,Wayne Selden,SG,NYK,2,-4,2,-4,1,1,2,0,0,0,5,-2,-2,-8,13,5,496
496,Alperen Şengün,C,HOU,498,-525,165,-232,29,393,370,236,272,-290,692,-27,-67,-1047,2655,1608,497
497,Collin Sexton,SG,CLE,136,-151,29,-39,11,36,46,40,0,-62,176,-15,-10,-252,474,222,498
498,Landry Shamet,SG,PHO,382,-485,68,-81,123,126,216,112,36,-82,573,-103,-13,-648,1636,988,499
499,Day'Ron Sharpe,PF,BRK,172,-149,24,-41,2,160,34,40,60,-60,198,23,-17,-250,690,440,500
500,Pascal Siakam,PF,TOR,1192,-1207,284,-379,75,580,720,340,168,-362,1551,-15,-95,-1948,4910,2962,501
501,Chris Silva,PF,TOT,16,-15,10,-12,0,36,14,0,4,-16,26,1,-2,-43,106,63,502
502,Marko Simonovic,C,CHI,8,-15,8,-11,1,10,0,4,4,-4,17,-7,-3,-30,52,22,503
503,Anfernee Simons,SG,POR,706,-797,103,-116,179,151,442,120,24,-230,988,-91,-13,-1143,2713,1570,504
504,Zavier Simpson,PG,OKC,38,-52,5,-5,1,21,60,20,16,-20,44,-14,0,-77,205,128,505
505,Jericho Sims,PF,NYK,78,-54,12,-29,0,169,42,44,88,-40,90,24,-17,-123,523,400,506
506,Deividas Sirvydis,SG,DET,2,-10,0,0,1,6,2,12,4,0,3,-8,0,-10,30,20,507
507,Javonte Smart,PG,TOT,38,-60,5,-6,8,24,32,24,12,-22,51,-22,-1,-88,194,106,508
508,Marcus Smart,PG,BOS,600,-718,142,-179,119,270,834,476,72,-318,861,-118,-37,-1215,3374,2159,509
509,Dennis Smith Jr.,PG,POR,158,-189,42,-64,6,88,264,180,48,-102,206,-31,-22,-355,992,637,510
510,Ish Smith,PG,TOT,370,-430,15,-24,25,140,488,188,92,-156,410,-60,-9,-610,1728,1118,511
511,Jalen Smith,PF,TOT,352,-350,78,-102,40,307,48,60,164,-84,470,2,-24,-536,1519,983,512
512,Xavier Sneed,SF,TOT,4,-10,0,0,1,6,2,0,0,0,5,-6,0,-10,18,8,513
513,Tony Snell,SG,TOT,138,-171,4,-4,45,103,56,64,36,-38,187,-33,0,-213,633,420,514
514,Jaden Springer,SG,PHI,2,-1,0,0,0,2,0,0,8,-2,2,1,0,-3,14,11,515
515,Cassius Stanley,SG,DET,38,-46,10,-10,4,19,8,20,8,-12,52,-8,0,-68,159,91,516
516,Nik Stauskas,SG,TOT,10,-14,4,-6,4,3,4,0,0,-2,18,-4,-2,-22,43,21,517
517,Lance Stephenson,PG-SG,TOT,294,-323,63,-80,27,127,330,96,16,-144,384,-29,-17,-547,1337,790,518
518,Lamar Stevens,PF,CLE,312,-319,53,-75,18,164,88,124,72,-82,383,-7,-22,-476,1214,738,519
519,Isaiah Stewart,C,DET,500,-490,74,-103,15,617,164,88,312,-170,589,10,-29,-763,2359,1596,520
520,Max Strus,SF,MIA,498,-564,42,-53,181,202,184,112,64,-114,721,-66,-11,-731,2004,1273,521
521,Jalen Suggs,PG,ORL,396,-548,126,-163,42,171,418,236,76,-286,564,-152,-37,-997,2029,1032,522
522,Craig Sword,SG,WAS,6,-4,0,0,0,0,2,16,0,-2,6,2,0,-6,30,24,523
523,Keifer Sykes,PG,IND,138,-190,15,-17,27,45,124,48,16,-66,180,-52,-2,-273,593,320,524
524,Jae'Sean Tate,PF,HOU,726,-729,130,-184,63,420,444,288,164,-278,919,-3,-54,-1191,3154,1963,525
525,Jayson Tatum,SF,BOS,1416,-1564,400,-469,230,609,668,300,196,-434,2046,-148,-69,-2467,5865,3398,526
526,Terry Taylor,SG,IND,270,-220,36,-51,12,172,82,56,32,-46,318,50,-15,-317,978,661,527
527,Garrett Temple,SG,NOP,222,-295,28,-41,59,143,148,172,92,-84,309,-73,-13,-420,1173,753,528
528,Emanuel Terry,PF,PHO,0,-5,0,0,0,15,4,4,0,-10,0,-5,0,-15,23,8,529
529,Tyrell Terry,PG,MEM,2,-1,0,0,0,0,0,0,0,0,2,1,0,-1,4,3,530
530,Jon Teske,C,MEM,0,-1,0,-2,0,2,2,4,0,0,0,-1,-2,-3,8,5,531
531,Daniel Theis,C,TOT,302,-291,49,-72,33,228,82,80,124,-92,384,11,-23,-455,1282,827,532
532,Brodric Thomas,SG,BOS,16,-18,3,-5,2,10,22,4,4,-12,21,-2,-2,-35,82,47,533
533,Cam Thomas,SG,BRK,436,-503,87,-105,47,161,156,132,32,-110,570,-67,-18,-718,1621,903,534
534,Isaiah Thomas,PG,TOT,134,-167,22,-26,28,29,68,28,20,-30,184,-33,-4,-223,513,290,535
535,Matt Thomas,SG,CHI,110,-134,16,-20,35,50,40,32,12,-16,161,-24,-4,-170,456,286,536
536,Klay Thompson,SG,GSW,492,-573,46,-51,114,125,176,64,68,-86,652,-81,-5,-710,1737,1027,537
537,Tristan Thompson,PF,TOT,282,-267,61,-116,1,288,68,92,84,-90,344,15,-55,-473,1220,747,538
538,JT Thor,PF,CHO,48,-55,12,-20,7,43,38,32,44,-20,67,-7,-8,-95,291,196,539
539,Matisse Thybulle,SG,PHI,300,-300,34,-43,45,151,150,460,284,-78,379,0,-9,-421,1803,1382,540
540,Killian Tillie,C,MEM,86,-127,5,-8,27,60,44,92,60,-26,118,-41,-3,-161,492,331,541
541,Xavier Tillman Sr.,PF,MEM,196,-216,46,-71,10,161,124,196,60,-68,252,-20,-25,-355,1045,690,542
542,Isaiah Todd,PF,WAS,14,-26,2,-6,4,12,8,16,8,-8,20,-12,-4,-40,84,44,543
543,Obi Toppin,PF,NYK,502,-473,94,-124,52,268,154,100,132,-112,648,29,-30,-709,1950,1241,544
544,Juan Toscano-Anderson,SF,GSW,230,-235,40,-70,28,176,254,192,68,-136,298,-5,-30,-441,1286,845,545
545,Karl-Anthony Towns,C,MIN,1284,-1214,384,-467,150,727,538,288,332,-452,1818,70,-83,-2133,5521,3388,546
546,Gary Trent Jr.,SG,TOR,900,-1086,174,-204,209,191,282,488,76,-146,1283,-186,-30,-1436,3603,2167,547
547,P.J. Tucker,PF,MIA,414,-428,45,-61,80,387,298,232,60,-132,539,-14,-16,-621,2055,1434,548
548,Rayjon Tucker,SG,TOT,12,-9,5,-7,4,8,20,16,0,-2,21,3,-2,-18,86,68,549
549,Myles Turner,C,IND,400,-393,79,-105,61,297,88,112,472,-108,540,7,-26,-606,2049,1443,550
550,Jonas Valančiūnas,C,NOP,1020,-938,237,-289,57,843,380,164,240,-358,1314,82,-52,-1585,4255,2670,551
551,Denzel Valentine,SG,TOT,50,-66,0,0,19,42,22,32,0,-24,69,-16,0,-90,234,144,552
552,Jarred Vanderbilt,PF,MIN,424,-361,86,-131,2,624,188,396,184,-146,512,63,-45,-638,2416,1778,553
553,Fred VanVleet,PG,TOR,884,-1097,194,-222,242,289,868,444,140,-340,1320,-213,-28,-1659,4381,2722,554
554,Devin Vassell,SF,SAS,652,-764,83,-99,137,306,272,304,164,-116,872,-112,-16,-979,2790,1811,555
555,Gabe Vincent,PG,MIA,428,-513,44,-54,119,126,420,248,48,-196,591,-85,-10,-763,2024,1261,556
556,Nikola Vučević,C,CHI,1092,-1154,92,-121,104,804,472,280,284,-272,1288,-62,-29,-1547,4416,2869,557
557,Dean Wade,PF,CLE,198,-217,20,-30,51,150,104,116,28,-32,269,-19,-10,-279,936,657,558
558,Franz Wagner,SF,ORL,912,-975,189,-219,96,356,462,272,136,-238,1197,-63,-30,-1432,3620,2188,559
559,Moritz Wagner,C,ORL,394,-396,104,-129,66,232,174,80,52,-112,564,-2,-25,-637,1666,1029,560
560,Ish Wainright,PF,PHO,82,-104,7,-12,19,54,30,80,24,-26,108,-22,-5,-142,404,262,561
561,Kemba Walker,PG,NYK,298,-370,60,-71,73,111,262,104,28,-96,431,-72,-11,-537,1367,830,562
562,Lonnie Walker IV,SG,SAS,622,-764,116,-148,111,181,304,176,76,-142,849,-142,-32,-1054,2435,1381,563
563,M.J. Walker,SG,PHO,0,-4,0,0,0,1,2,8,0,0,0,-4,0,-4,11,7,564
564,Tyrone Wallace,SG,NOP,14,-20,1,-5,2,8,2,12,4,-4,17,-6,-4,-29,60,31,565
565,Derrick Walton,PG,DET,12,-26,4,-4,3,10,42,28,16,-22,19,-14,0,-52,134,82,566
566,Brad Wanamaker,PG,TOT,56,-77,23,-25,4,39,110,28,24,-46,83,-21,-2,-148,367,219,567
567,Duane Washington Jr.,PG,IND,346,-427,46,-61,81,83,170,104,12,-114,473,-81,-15,-602,1315,713,568
568,P.J. Washington,C,CHO,500,-532,58,-81,110,337,294,228,244,-164,668,-32,-23,-777,2439,1662,569
569,Yuta Watanabe,SF,TOR,112,-138,24,-40,27,92,42,44,64,-38,163,-26,-16,-216,568,352,570
570,Lindy Waters III,SG,OKC,142,-175,4,-5,53,73,48,76,32,-22,199,-33,-1,-202,627,425,571
571,Tremont Waters,PG,TOT,8,-14,0,0,2,4,14,20,0,-8,10,-6,0,-22,58,36,572
572,Trendon Watford,SF,POR,284,-267,71,-94,9,199,162,100,112,-88,364,17,-23,-449,1301,852,573
573,Paul Watson,SF,OKC,24,-35,1,-2,6,27,16,12,12,-8,31,-11,-1,-45,129,84,574
574,Quinndary Weatherspoon,SG,GSW,24,-21,5,-5,1,14,10,4,4,-6,30,3,0,-32,92,60,575
575,Russell Westbrook,PG,LAL,1096,-1233,266,-399,79,580,1100,300,80,-590,1441,-137,-133,-2222,4942,2720,576
576,Coby White,PG,CHI,558,-644,78,-91,136,182,352,116,44,-140,772,-86,-13,-875,2238,1363,577
577,Derrick White,SG,TOT,674,-800,203,-235,115,261,732,256,232,-238,992,-126,-32,-1273,3465,2192,578
578,Hassan Whiteside,C,UTA,430,-330,104,-167,0,494,52,88,412,-106,534,100,-63,-603,2114,1511,579
579,Joe Wieskamp,SG,SAS,40,-56,7,-13,14,14,18,16,12,-4,61,-16,-6,-73,182,109,580
580,Aaron Wiggins,SG,OKC,312,-337,62,-85,42,178,136,120,40,-108,416,-25,-23,-530,1306,776,581
581,Andrew Wiggins,SF,GSW,950,-1019,149,-235,157,325,322,304,204,-222,1256,-69,-86,-1476,3667,2191,582
582,Lindell Wigginton,PG,MIL,52,-61,19,-35,9,25,46,20,4,-24,80,-9,-16,-120,255,135,583
583,Brandon Williams,PG,POR,210,-282,68,-97,31,74,188,96,40,-116,309,-72,-29,-495,1016,521,584
584,Grant Williams,PF,BOS,410,-432,86,-95,106,274,156,152,228,-124,602,-22,-9,-651,2014,1363,585
585,Kenrich Williams,SF,OKC,292,-317,30,-55,41,220,216,176,40,-92,363,-25,-25,-464,1378,914,586
586,Lou Williams,PG,ATL,250,-320,67,-78,37,87,210,112,12,-86,354,-70,-11,-484,1129,645,587
587,Patrick Williams,PF,CHI,108,-102,30,-41,15,69,30,36,36,-32,153,6,-11,-175,477,302,588
588,Robert Williams,C,BOS,542,-368,65,-90,0,588,242,224,536,-126,607,174,-25,-584,2804,2220,589
589,Ziaire Williams,SF,MEM,382,-424,43,-55,76,129,130,140,48,-82,501,-42,-12,-561,1449,888,590
590,D.J. Wilson,PF,TOR,22,-15,8,-10,0,16,10,20,4,-4,30,7,-2,-29,110,81,591
591,Dylan Windler,SF,CLE,74,-98,15,-18,21,89,68,56,12,-32,110,-24,-3,-148,445,297,592
592,Justise Winslow,PF,TOT,220,-257,39,-66,15,202,168,140,100,-98,274,-37,-27,-421,1158,737,593
593,Cassius Winston,PG,WAS,8,-11,4,-4,2,1,14,0,0,-6,14,-3,0,-21,43,22,594
594,Christian Wood,C,HOU,880,-878,207,-332,131,686,310,216,260,-252,1218,2,-125,-1462,3908,2446,595
595,Robert Woodard II,SF,SAC,4,-16,2,-2,1,11,6,4,4,-2,7,-12,0,-20,39,19,596
596,Delon Wright,SG,ATL,244,-269,54,-63,44,220,376,372,76,-90,342,-25,-9,-422,1728,1306,597
597,McKinley Wright IV,PG,MIN,4,-3,0,0,1,0,6,0,0,-2,5,1,0,-5,16,11,598
598,Moses Wright,PF,TOT,2,-4,3,-3,0,3,4,0,4,0,5,-2,0,-7,21,14,599
599,Gabe York,SG,IND,4,-7,3,-5,1,2,8,8,4,-2,8,-3,-2,-14,38,24,600
600,Thaddeus Young,PF,TOT,282,-272,23,-49,17,208,208,216,72,-104,322,10,-26,-425,1348,923,601
601,Trae Young,PG,ATL,1422,-1544,500,-553,233,284,1474,288,28,-606,2155,-122,-53,-2703,6384,3681,602
602,Omer Yurtseven,C,MIA,260,-247,38,-61,1,294,98,68,80,-82,299,13,-23,-390,1138,748,603
603,Cody Zeller,C,POR,102,-90,38,-49,0,125,44,32,24,-38,140,12,-11,-177,505,328,604
604,Ivica Zubac,C,LAC,620,-495,165,-227,0,644,240,144,308,-228,785,125,-62,-950,2906,1956,605
